1111
10E1
1001
1001
1001
1001
1001
1P01
1101
1C11
1111